GGGGGGGGGGGGGGGGGGGGGGGGGGGGGGGGGGGGGGGGGG
GGGGGGGGGGGGGGGGGGGGGGGGGGGGGGGGGGGGGGGGGG
GGGGGGGGGSGGGGGGGGGGGGGGGGGGGGGGGGGGGGGGGG
GGGGGGGGGGGGGGGGGGGGGGGGGGGGGGGGGGGGGGGGGG
GGGGGGGGGGGGGGGGGGGGGGGGGGGGGGGGGGGGGGGGGG
GGB+GGGGGGGGGbGGGGGGGGGGGGGGGGGGGGGGGGGGGG
GG++GGGGGGGGGGGGGGGGGGGGGGGGGGGGGGGGGGGGGG
GGGGGGGDDDDDDDDDDDDDDDDDDDDDDDDDDDDDDDDGGG
GGGGGGGDDCCCDDDDDDDDDDDDDDDDDDDDDDDDDDDGGG
GGW+GwGDDCCCDDDDDDDDDDDDDDDDDDDDDDDDDDDGGG
GG++GGGDDCCCDDDDDDDDDDDDDDDDDDDDDDDDDDDGGG
GGGGGGGDDDDDDDDDDDDDDDDDDDDDDDDDDDDDDDDGGG
GGGGGGGDDDDDDDDDDDDDDDDDDDDDDDDDDDDDDDDGGG
GGGGGGGDDDDDDDDDDDDDDDDDDDDDDDDDDDDDDDDGGG
GGGGGGGDDDDDDDDDDDDDDDDDDDDDDDDDDDDDDDDGGG
GGGGGGGDDDDDDDDDDDDDDDDDDDDDDDDDDDDDDDDGGG
GGGGGGGDDDDDDDDDDDDDDDDDDDDDDDDDDDDDDDDGGG
GGGGGGGDDDDDDDDDDDDDDDDDDDDDDDDDDDDDDDDGGG
GGGGGGGGGGGGGGGGGGGGGGGGGGGGGGGGGGGGGGGGGG
GGGGGGGGGGGGGGGGGGGGGGGGGGGGGGGGGGGGGGGGGG
GGGGGGGGGGGGGGGGGGGGGGGGGGGGGGGGGGGGGGGGGG