GGGGGGGGGGGGGGGGGGGGGGGGGGGGGGGGGGGGGGGGGGGGG
GGGGGGGGGGGGGGGGGGGGGGGGGGGGGGGGGGGGGGGGGGGGG
GGGGGGGSGGGGGGGGGGGGGGGGGGGGGGGGGGGGGGGGGGGGG
GGGDDDDDDDDDDDDDDDDDDDDDDDDDDDDDDDDDDDDDDDGGG
GGGDDDCCDDDDDDDDDDDDDDDDDDDDDDDDDDDDDDDDDDGGG
GGGDDDCCDDDDDDDDDDDDDDDDDDDDDDDDDDDDDDDDDDGGG
GGGDDDDDDDDDDDDDDDDDDDDDDDDDDDDDDDDDDDDDDDGGG
GGGDDDDDDDDDDDDDDDDDDDDDDDDDDDDDDDDDDDDDDDGGG
GGGDDDDDDDDDDDDDDDDDDDDDDDDDDDDDDDDDDDDDDDGGG
GGGDDDDDDDDDDDDDDDDDDDDDDDDDDDDDDDDDDDDDDDGGG
GGGGGGGGGGGGGGGGGGGGGGGGGGGGGGGGGGGGGGGGGGGGG
GGGGGGGGGGGGGGGGGGGGGGGGGGGGGGGGGGGGGGGGGGGGG
GGGGGGGGGGGGGGGGGGGGGGGGGGGGGGGGGGGGGGGGGGGGG